1111111111111
1P00C0E0000E1
1011111111001
1000000000001
1000000000001
1111111111111
