1111111111111
1P00C000000E1
1011111111101
1011111111101
100000C000001
1111111111111
