1111111111111
1P010000000C1
10000C0000011
1C0001E000001
1111111111111
